NO ./textures/windows.xpm
SO ./textures/explorer2.xpm
WE ./textures/mspaint.xpm
EA ./textures/errors.xpm
SP ./textures/clippy.xpm
DO ./textures/tkt.xpm

F 62,191,13
C 10,36,106

        1111111111111111111111111
        1000000000110000000000001
        1011000001110000000200001
        1001000000000000000000001
111111111011000001110000000000001
100000000011000001113111111111111
11110111111111011100000010001
11110111111111011101010030001
11000000110101011100000010001
10000000000000001100200010001
10002000000000001101010010001
11000001110101011111011110N0111
11110111 1110101 101111010001
11111111 1111111 111111111111