NO ./textures/windows.xpm
SO ./textures/explorer.xpm
WE ./textures/mspaint.xpm
EA ./textures/errors.xpm
F 150,150,150
C 100,100,255

111111
10  01
10N 01
111111
