NO ./textures/wall1.xpm
SO ./textures/wall2.xpm
WE ./textures/wall3.xpm
EA ./textures/wall4.xpm
F 150,150,150
C 100,100,255

111111
10  01     // <- ❌ trou non fermé
10N 01
111111
