NO ./textures/green_yellow_wall.xpm
SO ./textures/bluewall.xpm
WE ./textures/blue_brown_wall.xpm
EA ./textures/bluevertical.xpm
SP ./textures/Dog1.xpm
F 180,180,180
C 60,60,60

        1111111111111111111111111
        1000000000110000000000001
        1011000001110000000020001
        1001000000000000000000001
111111111011000001110000000000001
100000000011000001110111111111111
11110111111111011100000010001
11110111111111011101010000001
11000000110101011100000010201
10000000000000001100000010001
10000000000000001101010010001
11000001110101011111011110N0111
11110111 1110101 101111010001
11111111 1111111 111111111111